XXXXXXXXXXXXX
X           X
X XXX XXXXX X
X X  XX  X  X
X XXX X XXX X
X   X    X  X
X X X XXX XXX
X X X  X    X
X X X X X X X
X X X  XXXXXX
X XXX X X X X
X      X    X
XXXXXXXXXXXXX