XXXXXXXXXXX
X  XXXXXX X
X   XXXX  X
XX  XXXXX X
XX   XXXXXX
XX    XXXXX
XX  XXXXXHX
XXXXXX XX X
XXXXXH XX X
X   HH    X
XXXXXXXXXXX
