XXXXXXXXXXX
X  XX  XX X
X   XX X  X
X   XXXXX X
XX    XXXXX
XX     XX X
XX  X XXXHX
XXXXXX XX X
XXXXX  XX X
X   HH    X
XXXXXXXXXXX
