XXXXXXXXXXX
X  XX  XX X
X   XX    X
X   XXXX  X
XX    XXX X
X       X X
XX  X XXXHX
XXXXX  XX X
X X X  X  X
X   HH    X
XXXXXXXXXXX
