XXXXXXXXXXX
X  XX XXX X
X   XX X  X
X   XXXXX X
XX   XXXXXX
XX    XXXXX
XX  XXXXXHX
XXXXXX XX X
XXXXX  XX X
X   HH    X
XXXXXXXXXXX
