             
 XXXXXXXXXXX 
 XXXXXXXXXXX 
 XXXX XXXXXX 
 XXX XXXXXXX 
 XXXXXXXX X  
 XXXXXXXXXXX 
 XXXXXXX  XX 
 XXXXXXXXXXX 
   XXXXXXXXX 
 XXXXXXXXXXX 
 XXXXXXXXXXX 
             